[
    {
	"name": "centralRoom",
	"content": [
	    3, 3, 4, 4, 3, 4, 4, 3, 3,
	    3, 2, 2, 2, 2, 2, 2, 2, 3,
	    4, 2, 3, 2, 3, 2, 3, 2, 4,
	    4, 2, 2, 2, 2, 2, 2, 2, 4,
	    3, 2, 3, 2, 9, 2, 3, 2, 3,
	    4, 2, 2, 2, 2, 2, 2, 2, 4,
	    4, 2, 3, 2, 3, 2, 3, 2, 4,
	    3, 2, 2, 2, 2, 2, 2, 2, 3,
	    3, 3, 4, 4, 3, 4, 4, 3, 3
	]
    },
    {
	"name": "1",
	"content": [
            3, 3, 3, 0, 0, 0, 3, 3, 3,
            3, 7, 0, 0, 0, 0, 0, 7, 3,
            3, 0, 0, 0, 0, 0, 0, 0, 3,
            0, 0, 0, 3, 4, 3, 0, 0, 0,
            0, 0, 0, 4, 11, 4, 0, 0, 0,
            0, 0, 0, 3, 4, 3, 0, 0, 0,
            3, 0, 0, 0, 0, 0, 0, 0, 3,
            3, 7, 0, 0, 0, 0, 0, 7, 3,
            3, 3, 3, 0, 0, 0, 3, 3, 3
	]
    },	
    {
	"name": "2",
	"content": [
            0, 0, 0, 0, 0, 0, 0, 0, 0,
            0, 5, 0, 0, 0, 0, 0, 5, 0,
            0, 0, 0, 0, 3, 0, 0, 0, 0,
            0, 0, 0, 4, 0, 4, 0, 0, 0,
            0, 0, 3, 0, 11, 0,3, 0, 0,
            0, 0, 0, 4, 0, 4, 0, 0, 0,
            0, 0, 0, 0, 3, 0, 0, 0, 0,
            0, 5, 0, 0, 0, 0, 0, 5, 0,
            0, 0, 0, 0, 0, 0, 0, 0, 0
	]
    }
]
