[
    {
	"name": "centralRoom",
	"content": [
	    3, 3, 4, 4, 3, 4, 4, 3, 3,
	    3, 2, 2, 2, 2, 2, 2, 2, 3,
	    4, 2, 3, 2, 3, 2, 3, 2, 4,
	    4, 2, 2, 2, 2, 2, 2, 2, 4,
	    3, 2, 3, 2, 9, 2, 3, 2, 3,
	    4, 2, 2, 2, 2, 2, 2, 2, 4,
	    4, 2, 3, 2, 3, 2, 3, 2, 4,
	    3, 2, 2, 2, 2, 2, 2, 2, 3,
	    3, 3, 4, 4, 3, 4, 4, 3, 3
	]
    },
    {
	"name": "1",
	"content": [
            3, 3, 3, 0, 0, 0, 3, 3, 3,
            3, 7, 0, 0, 0, 0, 0, 7, 3,
            3, 0, 0, 0, 0, 0, 0, 0, 3,
            0, 0, 0, 3, 4, 3, 0, 0, 0,
            0, 0, 0, 4, 11, 4, 0, 0, 0,
            0, 0, 0, 3, 4, 3, 0, 0, 0,
            3, 0, 0, 0, 0, 0, 0, 0, 3,
            3, 7, 0, 0, 0, 0, 0, 7, 3,
            3, 3, 3, 0, 0, 0, 3, 3, 3
	]
    },	
    {
	"name": "2",
	"content": [
            0, 0, 0, 0, 0, 0, 0, 0, 0,
            0, 5, 0, 0, 0, 0, 0, 5, 0,
            0, 0, 0, 0, 3, 0, 0, 0, 0,
            0, 0, 0, 4, 0, 4, 0, 0, 0,
            0, 0, 3, 0, 11, 0,3, 0, 0,
            0, 0, 0, 4, 0, 4, 0, 0, 0,
            0, 0, 0, 0, 3, 0, 0, 0, 0,
            0, 5, 0, 0, 0, 0, 0, 5, 0,
            0, 0, 0, 0, 0, 0, 0, 0, 0
	]
    },
    {
	"name": "2",
	"content": [
            0, 0, 0, 0, 0, 0, 0, 0, 0,
            0, 5, 0, 0, 0, 0, 0, 5, 0,
            0, 0, 0, 0, 3, 0, 0, 0, 0,
            0, 0, 0, 4, 0, 4, 0, 0, 0,
            0, 0, 3, 0, 11, 0,3, 0, 0,
            0, 0, 0, 4, 0, 4, 0, 0, 0,
            0, 0, 0, 0, 3, 0, 0, 0, 0,
            0, 5, 0, 0, 0, 0, 0, 5, 0,
            0, 0, 0, 0, 0, 0, 0, 0, 0
	]
    },
    {
	"name": "3",
	"content": [
            3, 0, 0, 0, 0, 0, 0, 0, 0,
            3, 0, 0, 3, 0, 3, 3, 0, 0,
            3, 0, 0, 3, 4, 3, 6, 0, 0,
            0, 0, 0, 3, 0, 3, 0, 0, 0,
            0, 5, 0, 3, 11, 3,0, 5, 0,
            0, 0, 0, 3, 0, 3, 0, 0, 0,
            0, 0, 6, 3, 4, 3, 0, 0, 3,
            0, 0, 3, 3, 0, 3, 0, 0, 3,
            0, 0, 0, 0, 0, 0, 0, 0, 3
	]
    },
    {
	"name": "4",
	"content": [
            4, 0, 0, 0, 4, 0, 0, 0, 4,
            0, 4, 0, 0, 0, 0, 0, 4, 0,
            0, 0, 7, 4, 0, 4, 7, 0, 0,
            0, 0, 4, 8, 4, 8, 4, 0, 0,
            0, 4, 0, 4, 11, 4,0, 4, 0,
            0, 0, 4, 8, 4, 8, 4, 0, 0,
            0, 0, 7, 4, 0, 4, 7, 0, 0,
            0, 4, 0, 0, 0, 0, 0, 4, 0,
            4, 0, 0, 0, 4, 0, 0, 0, 4
	]
    },
    {
	"name": "5",
	"content": [
            0, 0, 0, 0, 0, 0, 0, 0, 0,
            0, 5, 0, 0, 0, 0, 0, 5, 0,
            0, 0, 0, 4, 3, 4, 0, 0, 0,
            0, 0, 4, 0, 0, 0, 4, 0, 0,
            0, 0, 3, 0, 11, 0,3, 0, 0,
            0, 0, 4, 0, 0, 0, 4, 0, 0,
            0, 0, 0, 4, 3, 4, 0, 0, 0,
            0, 5, 0, 0, 0, 0, 0, 5, 0,
            0, 0, 0, 0, 0, 0, 0, 0, 0
	]
    },
    {
	"name": "6",
	"content": [
            3, 3, 0, 0, 0, 0, 0, 3, 3,
            3, 0, 0, 0, 3, 0, 0, 0, 3,
            0, 0, 0, 3, 3, 3, 0, 0, 0,
            0, 0, 3, 3, 3, 3, 3, 0, 0,
            0, 3, 6, 3, 3, 3, 6, 3, 0,
            0, 0, 3, 3, 3, 3, 3, 0, 0,
            0, 0, 0, 3, 3, 3, 0, 0, 0,
            3, 0, 0, 0, 3, 0, 0, 0, 3,
            3, 3, 0, 0, 0, 0, 0, 3, 3
	]
    },
    {
	"name": "7",
	"content": [
            3, 3, 3, 2, 2, 2, 3, 3, 3,
            3, 3, 2, 2, 2, 2, 2, 3, 3,
            3, 2, 2, 2, 3, 2, 2, 2, 3,
            2, 2, 2, 2, 2, 2, 2, 2, 2,
            2, 2, 3, 2, 11, 2, 3, 2, 2,
            2, 2, 2, 2, 2, 2, 2, 2, 2,
            3, 2, 2, 2, 3, 2, 2, 2, 3,
            3, 3, 2, 2, 2, 2, 2, 3, 3,
            3, 3, 3, 2, 2, 2, 3, 3, 3
	]
    },
    {
	"name": "8",
	"content": [
            0, 0, 4, 0, 8, 0, 4, 0, 0,
            0, 8, 4, 0, 0, 0, 4, 8, 0,
            4, 4, 3, 3, 3, 3, 3, 4, 4,
            0, 0, 3, 3, 3, 3, 3, 0, 0,
            8, 0, 3, 3, 11, 3,3, 0, 8,
            0, 0, 3, 3, 3, 3, 3, 0, 0,
            4, 4, 3, 3, 3, 3, 3, 4, 4,
            0, 8, 4, 0, 0, 0, 4, 8, 0,
            0, 0, 4, 0, 8, 0, 4, 0, 0
	]
    },
    {
	"name": "9",
	"content": [
            4, 4, 0, 0, 0, 0, 0, 4, 4,
            4, 3, 3, 3, 4, 3, 3, 3, 4,
            0, 3, 0, 4, 4, 4, 0, 3, 0,
            0, 3, 4, 3, 3, 3, 4, 3, 0,
            0, 3, 4, 0, 11, 0,4, 3, 0,
            0, 3, 4, 3, 3, 3, 4, 3, 0,
            0, 3, 0, 4, 4, 4, 0, 3, 0,
            4, 3, 3, 3, 4, 3, 3, 3, 4,
            4, 4, 0, 0, 0, 0, 0, 4, 4
	]
    },
    {
	"name": "10",
	"content": [
            3, 3, 3, 4, 0, 4, 3, 3, 3,
            3, 6, 3, 0, 4, 0, 3, 6, 3,
            3, 3, 7, 4, 0, 4, 7, 3, 3,
            4, 0, 4, 0, 4, 0, 4, 0, 4,
            0, 4, 0, 4, 3, 4, 0, 4, 0,
            4, 0, 4, 0, 4, 0, 4, 0, 4,
            3, 3, 7, 4, 0, 4, 7, 3, 3,
            3, 6, 3, 0, 4, 0, 3, 6, 3,
            3, 3, 3, 4, 0, 4, 3, 3, 3
	]
    },
    {
	"name": "11",
	"content": [
            4, 4, 4, 4, 4, 4, 4, 4, 4,
            4, 0, 4, 4, 0, 4, 4, 0, 4,
            4, 4, 4, 4, 4, 4, 4, 4, 4,
            4, 4, 4, 4, 4, 4, 4, 4, 4,
            4, 0, 4, 4, 0, 4, 4, 0, 4,
            4, 4, 4, 4, 4, 4, 4, 4, 4,
            4, 4, 4, 4, 4, 4, 4, 4, 4,
            4, 0, 4, 4, 0, 4, 4, 0, 4,
            4, 4, 4, 4, 4, 4, 4, 4, 4
	]
    },
    {
	"name": "12",
	"content": [
            3, 3, 3, 2, 2, 2, 3, 3, 3,
            3, 2, 2, 2, 2, 2, 2, 2, 3,
            3, 2, 2, 2, 2, 2, 2, 2, 3,
            2, 2, 2, 3, 3, 3, 2, 2, 2,
            2, 2, 2, 3, 3, 3, 2, 2, 2,
            2, 2, 2, 3, 3, 3, 2, 2, 2,
            3, 2, 2, 2, 2, 2, 2, 2, 3,
            3, 2, 2, 2, 2, 2, 2, 2, 3,
            3, 3, 3, 2, 2, 2, 3, 3, 3
	]
    },
    {
	"name": "13",
	"content": [
            3, 3, 3, 2, 2, 2, 3, 3, 3,
            3, 2, 2, 2, 2, 2, 2, 2, 3,
            3, 2, 2, 2, 2, 2, 2, 2, 3,
            2, 2, 2, 3, 2, 3, 2, 2, 2,
            2, 2, 2, 2, 11, 2, 2, 2, 2,
            2, 2, 2, 3, 2, 3, 2, 2, 2,
            3, 2, 2, 2, 2, 2, 2, 2, 3,
            3, 2, 2, 2, 2, 2, 2, 2, 3,
            3, 3, 3, 2, 2, 2, 3, 3, 3
	]
    },
    {
	"name": "14",
	"content": [
            3, 3, 3, 0, 8, 0, 3, 3, 3,
            3, 7, 3, 0, 0, 0, 3, 7, 3,
            3, 3, 3, 0, 3, 0, 3, 3, 3,
            0, 0, 0, 8, 0, 8, 0, 0, 0,
            8, 0, 3, 0, 11,0, 3, 0, 8,
            0, 0, 0, 8, 0, 8, 0, 0, 0,
            3, 3, 3, 0, 3, 0, 3, 3, 3,
            3, 7, 3, 0, 0, 0, 3, 7, 3,
            3, 3, 3, 0, 8, 0, 3, 3, 3
	]
    },
    {
	"name": "15",
	"content": [
            3, 3, 3, 0, 8, 0, 3, 3, 3,
            3, 7, 3, 0, 0, 0, 3, 7, 3,
            3, 3, 3, 8, 0, 8, 3, 3, 3,
            0, 0, 8, 0, 0, 0, 8, 0, 0,
            8, 0, 0, 0, 11,0, 0, 0, 8,
            0, 0, 8, 0, 0, 0, 8, 0, 0,
            3, 3, 3, 8, 0, 8, 3, 3, 3,
            3, 7, 3, 0, 0, 0, 3, 7, 3,
            3, 3, 3, 0, 8, 0, 3, 3, 3
	]
    },
    {
	"name": "16",
	"content": [
            3, 3, 3, 0, 0, 0, 3, 3, 3,
            3, 3, 3, 0, 1, 0, 3, 3, 3,
            3, 3, 7, 0, 0, 0, 7, 3, 3,
            0, 0, 0, 0, 0, 0, 0, 0, 0,
            0, 1, 0, 0, 7, 0, 0, 1, 0,
            0, 0, 0, 0, 0, 0, 0, 0, 0,
            3, 3, 7, 0, 0, 0, 7, 3, 3,
            3, 3, 3, 0, 1, 0, 3, 3, 3,
            3, 3, 3, 0, 0, 0, 3, 3, 3
	]
    },
    {
	"name": "17",
	"content": [
            0, 0, 0, 0, 0, 0, 0, 0, 0,
            0, 3, 3, 3, 3, 3, 3, 3, 0,
            0, 3, 6, 3, 3, 3, 6, 3, 0,
            0, 3, 3, 3, 3, 3, 3, 3, 0,
            0, 3, 3, 3, 3, 3, 3, 3, 0,
            0, 3, 3, 3, 3, 3, 3, 3, 0,
            0, 3, 6, 3, 3, 3, 6, 3, 0,
            0, 3, 3, 3, 3, 3, 3, 3, 0,
            0, 0, 0, 0, 0, 0, 0, 0, 0
	]
    },
    {
	"name": "18",
	"content": [
            0, 0, 0, 0, 0, 0, 0, 0, 0,
            0, 0, 3, 0, 3, 0, 3, 0, 0,
            0, 0, 0, 0, 0, 0, 0, 0, 0,
            0, 0, 3, 3, 3, 3, 3, 0, 0,
            4, 0, 0, 0, 8, 11,3, 0, 3,
            0, 0, 3, 3, 3, 3, 3, 0, 0,
            0, 0, 0, 0, 0, 0, 0, 0, 0,
            0, 0, 3, 0, 3, 0, 3, 0, 0,
            0, 0, 0, 0, 0, 0, 0, 0, 0
	]
    }
]
